################################
#                              #
# # # # # # # #  # # # # # # # #
#                              #
# # # # # # # #  # # # # # # # #
#                              #
# # # # # # # #  # # # # # # # #
#                              #
#                              #
# # # # # # # #  # # # # # # # #
#                              #
# # # # # # # #  # # # # # # # #
#                              #
# # # # # # # #  # # # # # # # #
#                              #
################################